WWWWWWWWWWWWWWWWWWWWWWWWWWWWWWWWWWWWWWWWWWWWWWWWWWWWWWWWWWWWWWWWWWWWWWWWWWWWWWWWWWWWWWWWWWWWWWWWWWWWWWWWWWWWWWWWWWWWWWWW
WWWWWWWWWWWWWWWWWWWWWWWWWWWWWWWWWWWWWWWWW      W       W     W      W                   W                      W  WWSWWW
WWWWWWWWWWWWWWWWWWWWWWWWWWWWWWWWWWWWWWWWW      W       W     W      W                   W                      W       W
WWWWWWWWWWWWWWWWWWWWWWWWWWWWWWWWWWWWWWWWW      W       W     W      J                   W                      W       W
WWWWWWWWWWWWWWWWWWWWWWWWWWWWWWWWWWWWWWWWWWWWWWWW       W     W      W                   W                      W       W
WWW                                                    W     W      W     WWWWWWWWW     W              WWWWWWWWW       W
WWW                                                    W     W      W     W       W     WWWWWWWWWW     W               W
WWE                                                    W     W      W     W       W              W     W               W
WWW                                                    W     W      W     W       W              W     W               W
WWW                                                    WWWWWWWWWWWWWW     W       W              W     W     WWWWWWWWWWW
WWWWWWWWWWW       WWWWWWWWWWWWWW                                          W       W              W     W     W         W
WWWWWWWWWWW       WWWWWWWWWWWWWW                                          W       W              W     W     W         W
WWWWWWWWWWW       WWWWWWWWWWWWWW                                          W       WWWWWWWWWW     W     W     W         W
WWWWWWWWWWW       WWWWWWWWWWWWWW                                          W                W     W     W     W         W
WWWWWWWWWWW       WWWWWWWWWWWWWW                                          W                W     W     W     WWWWWWWWWWW
WWWWWWWWWWW       WWWWWWWWWWWWWW     WWWWWWWWWWW       WWWWWWWWWWWWWWWWWWWW                W     W     W               W
WWWWWWWWWWW       WWWWWWWWWWWWWW     W         W       W                                   W     W     W               W
WWWWWWWWWWW       WWWWWWWWWWWWWW     W         W       W                                   W     WWWWWWW               W
WWWWWWWWWWW                          W         W       W                                   W                 WWWWWWW   W
WWWWWWWWWWW                          W         W       W                                   W                 W     W   W
WWWWWWWWWWW       WWWWWWWWWWWWWW     W         W       W                                   W                 W     W   W
WWWWWWWWWWW       WWWWWWWWWWWWWW     W         W       W                                   W                 W     W   W
WWWWWWWWWWW       WWWWWWWWWWWWWW     W         W       W             WWWWWWWWWWWWW         W                 W     W   W
WWWWWWWWWWW       WWWWWWWWWWWWWW     W         W       W             W           W         WWWWWWWWWWWWW     W     W   W
WWWWWWWWWWW       WWWWWWWWWWWWWW     W         W       W             W           W                     W     W     W   W
WWWWWWWWWWW       WWWWWWWWWWWWWW     W         W       W             W           W                     W     WWWWWWW   W
WWWWWWWWWWW       WWWWWWWWWWWWWW     W         W       W             W           W                     W               W
WWWWWWWWWWW                          W         W       W             W           W                     W               W
WWWWWWWWWWW                          W         W       W             W           W        WWWWWWWWWWWWWW               W
WWWWWWWWWWW                          W         W       W             W           W        W                  WWWWWWW   W
WWWWWWWWWWW                          W         W       W             W           W        W                  W     W   W
WWWWWWWWWWWWW                        W         W       W             W      WWWWWW        W                  W     W   W
WWWWWWWWWWWWW                        W         W       WWWWWWWWWWWWWWW      W    W        W                  W     W   W
WWWWWWWWWWWWW                        W         W                            K    W        W                  W     W   W
WWWWWWWWWWWWW                        W         W                            W    W        W      WWWWWWWWW   W     W   W
WWWWWWWWWWWWW                        W         W                            W    W        W      W       W   WWWWWWW   W
WWWWWWWWWWWWW                        W         W       WWWWWWWWWWWWWWWWWWWWWW    W        W      W       W             W
WWWWWWWWWWWWW                        W         W       W                    WWWWWWWWWWWWWWW      W       W             W
WWWWWWWWWWWWW                        WWWWWWWWWWW       W                                  W      W       W             W
WWWWWWWWWWWWW                                          W                          WWWWWWWWW      W       W   WWWWWWW   W
WWWWWWWWWWWWW                                          W                          G              W       W   W     W   W
WWWWWWWWWWWWWWWWWWWWWWWWWWWWWWWWW                      W                          G              W       W   W     W   W
WWWWWWWWWWWWWWWWWWWWWWWWWWWWWWWWW                      W                          G              WWWWWWWWW   W     W   W
WWWWWWWWWWWWWWWWWWWWWWWWWWWWWWWWW                      W                          WWWWWWWWW                  WWWWWWW   W
WWWWWWWWWWWWWWWWWWWWWWWWWWWWWWWWW                      W                          WWWWWWWWW                            W
WWWWWWWWWWWWWWWWWWWWWWWWWWWWWWWWW                      W                                  W                            W
WWWWWWWWWWWWWWWWWWWWWWWWWWWWWWWWW                      WWWWWWWWWWWWWWWWWWWWWWWWWWWWWWWWWWWW                            W
W                                                                                         WWWWWWWW       WWWWWWWWWWWWWWW
W                                                                                         W      W       W             W
W                                                                                         W      W       W             W
W                                                               WWWWWWWWWWWWWWWWWWWWWWW   W      W       W             W
W                                                               W                     W   W      W       W             W
W                              WWWWWWWWWWWWWWWWW                W                     W   W      W       W             W
W                              W               W                WWWWWW                W   W      W       W             W
WMMMMMMMMMMMMMMMMMMMWWWWWWW    WWWWWWWWWWWWWWWWW                     W                W   WWWWWWWW       WWWWWWWWCWWWWWW
WWWWWWWWWWWWWWWWWWWWWWWWWWW    W    WWWWWWW    W                     W                W                                W
WWWWWWWWWWWWWWWWWWWWWWWWWWW    W    WWWWWWW    W                     W                W                                W
WWWWWWWWWWWWWWWWWWWWWWWWWWW    W    W     W    W                     WWWWWWWWWWWWWWWWWW                                W
WWWWWWWWWWWWWWWWWWWWWWWWWWW    W    W     W    W                                                                       W
WWWWWWWWWWWWWWWWWWWWWWWWWWW    WWWWWW     WWWWWW       WWWWWWW                                                         W
WWWWWWWWWWWWWWWWWWWWWWWWWWW    WWWWWW     WWWWWW       W     W                            WWWWWWWWWWWWWWW              W
WWWWWWWWWWWWWWWWWWWWWWWWWWW    W    W     W    W       W     W                            W             W              W
WWWWWWWWWWWWWWWWWWWWWWWWWWW    WWWWWW     WWWWWW       W     W                            W             W              W
WWWWWWWWWWWWWWWWWWWWWWWWWWW                            W     W                            W             W              W
WWWWWWWWWWWWWWWWWWWWWWWWWWW                            W     W                            W             W              W
WWWWWWWWWWWWWWWWWWWWWWWWWWW                            W     W                            W             W              W
WWWWWWWWWWWWWWWWWWWWWWWWWWWWWWWWWWWWWWWWWWWWWWWWWWWWWWWW     WWWWWWWWWWWWWWWWWWWWWWWWWWWWWW             WWWWWWWWWWWWWWWW
WWWWWWWWWWWWWWWWWWWWWWWWWWWWWWWWWWWWWWWWWWWWWWWWWWWWWWWWWWWWWWWWWWWWWWWWWWWWWWWWWWWWWWWWWWWWWWWWWWWWWWWWWWWWWWWWWWWWWWWW
