WWWWWWWWWWWWWWWWWWWWWWWWWWWWWWWWWWWWWWWWWWWWWWWWWWWWWWWWWWWWWWWWWWWWWWWWWWWWWWWWWWWWWWWWWWWWWWWWWWWWWWWWWWWWWWWWWWWWWWWW
WWWWWWWWWWWWWWWWWWWWWWWWWWWWWWWWWWWWWWWWW      W       W     W      W                   W                      W  WW WWW
WWWWWWWWWWWWWWWWWWWWWWWWWWWWWWWWWWWWWWWWW      W       W     W      W                   W                      W       W
WWWWWWWWWWWWWWWWWWWWWWWWWWWWWWWWWWWWWWWWW      W       W     W     W                    W                      W       W
WWWWWWWWWWWWWWWWWWWWWWWWWWWWWWWWWWWWWWWWWWWWWWWW       W     W      W                   W                      W       W
WWW                                                    W     W      W     WWWWWWWWW     W              WWWWWWWWW       W
WWW                                                    W     W      W     W       W     WWWWWWWWWW     W               W
WW                                                     W     W      W     W       W              W     W               W
WWW                                                    W     W      W     W       W              W     W               W
WWW                                                    WWWWWWWWWWWWWW     W       W              W     W     WWWWWWWWWWW
WWWWWWWWWWW       WWWWWWWWWWWWWW                                          W       W              W     W     W         W
WWWWWWWWWWW       WWWWWWWWWWWWWW                                          W       W              W     W     W         W
WWWWWWWWWWW       WWWWWWWWWWWWWW                                          W       WWWWWWWWWW     W     W     W         W
WWWWWWWWWWW       WWWWWWWWWWWWWW                                          W                W     W     W     W         W
WWWWWWWWWWW       WWWWWWWWWWWWWW                                          W                W     W     W     WWWWWWWWWWW
WWWWWWWWWWW       WWWWWWWWWWWWWW     WWWWWWWWWWW       WWWWWWWWWWWWWWWWWWWW                W     W     W               W
WWWWWWWWWWW       WWWWWWWWWWWWWW     W         W       W                                   W     W     W               W
WWWWWWWWWWW       WWWWWWWWWWWWWW     W         W       W                                   W     WWWWWWW               W
WWWWWWWWWWW                          W         W       W                                   W                 WWWWWWW   W
WWWWWWWWWWW                          W         W       W                                   W                 W     W   W
WWWWWWWWWWW       WWWWWWWWWWWWWW     W         W       W                                   W                 W     W   W
WWWWWWWWWWW       WWWWWWWWWWWWWW     W         W       W                                   W                 W     W   W
WWWWWWWWWWW       WWWWWWWWWWWWWW     W         W       W             WWWWWWWWWWWWW         W                 W     W   W
WWWWWWWWWWW       WWWWWWWWWWWWWW     W         W       W             W           W         WWWWWWWWWWWWW     W     W   W
WWWWWWWWWWW       WWWWWWWWWWWWWW     W         W       W             W           W                     W     W     W   W
WWWWWWWWWWW       WWWWWWWWWWWWWW     W         W       W             W           W                     W     WWWWWWW   W
WWWWWWWWWWW       WWWWWWWWWWWWWW     W         W       W             W           W                     W               W
WWWWWWWWWWW                          W         W       W             W           W                     W               W
WWWWWWWWWWW                          W         W       W             W           W        WWWWWWWWWWWWWW               W
WWWWWWWWWWW                          W         W       W             W           W        W                  WWWWWWW   W
WWWWWWWWWWW                          W         W       W             W           W        W                  W     W   W
WWWWWWWWWWWWW                        W         W       W             W      WWWWWW        W                  W     W   W
WWWWWWWWWWWWW                        W         W       WWWWWWWWWWWWWWW      W    W        W                  W     W   W
WWWWWWWWWWWWW                        W         W                             W   W        W                  W     W   W
WWWWWWWWWWWWW                        W         W                            W    W        W      WWWWWWWWW   W     W   W
WWWWWWWWWWWWW                        W         W                            W    W        W      W       W   WWWWWWW   W
WWWWWWWWWWWWW                        W         W       WWWWWWWWWWWWWWWWWWWWWW    W        W      W       W             W
WWWWWWWWWWWWW                        W         W       W                    WWWWWWWWWWWWWWW      W       W             W
WWWWWWWWWWWWW                        WWWWWWWWWWW       W                                  W      W       W             W
WWWWWWWWWWWWW                                          W                          WWWWWWWWW      W       W   WWWWWWW   W
WWWWWWWWWWWWW                                          W                         W               W       W   W     W   W
WWWWWWWWWWWWWWWWWWWWWWWWWWWWWWWWW                      W                         W               W       W   W     W   W
WWWWWWWWWWWWWWWWWWWWWWWWWWWWWWWWW                      W                         W               WWWWWWWWW   W     W   W
WWWWWWWWWWWWWWWWWWWWWWWWWWWWWWWWW                      W                          WWWWWWWWW                  WWWWWWW   W
WWWWWWWWWWWWWWWWWWWWWWWWWWWWWWWWW                      W                          WWWWWWWWW                            W
WWWWWWWWWWWWWWWWWWWWWWWWWWWWWWWWW                      W                                  W                            W
WWWWWWWWWWWWWWWWWWWWWWWWWWWWWWWWW                      WWWWWWWWWWWWWWWWWWWWWWWWWWWWWWWWWWWWWWWWWWW                     W
W                                                                                         WWWWWWWW       WWWWWWWWWWWWWWW
W                                                                                         W      W       W             W
W                                                                                         W      W       W             W
W                                                               WWWWWWWWWWWWWWWWWWWWWWW   W      W       W             W
W                                                               W                     W   W      W       W             W
W                              WWWWWWWWWWWWWWWWW                W                     W   W      W       W             W
W                              W               W                WWWWWW                W   W      W       W       W     W
WWWWWW WwWWWWW WWWWWWWWWWWW    WWWWWWWWWWWWWWWWW                     W                W   WWWWWWWW       WWWWWWWW WWWWWW
WWW WW      WW      WWW WWW    W    WWWWWWW    W                     W                W                                W
WWW WWWWWWW  WWWWWW     WWW    W    WWWWWWW    W                     WWWWWWWWWWWWWWWWWW                                W
W         WW   WW WWWWW WWW    W    W     W    W                                                                       W
W WWWW WWWWWWW WW WWWWW WWW    W    W     W    W                                                                       W
W WWWW    WWWW WW   WWW WWW    WWWWWW     WWWWWW       WWWWWWW                                                         W
W     WWW WWW   WWW WWW WWW    WWWWWW     WWWWWW       W     W                            WWWWWWWWWWWWWWW              W
WWWWW         WWWWW WWW WWW    W    W     W    W       W     W                            W             W              W
WWWWWWWW WWWW            WW    WWWWWW     WWWWWW       W     W                            W             W              W
W     WW WWWWWWWWW WWWWW WW                            W     W                            W             W              W
W WWW WW WWWWWWWWW WWWWW WW                            W     W                            W             W              W
W WWW    WWWWWWW   WWWWW WW                            W     W                            W             W              W
W WWWWWWWWWWWWWW WWW     WWWWWWWWWWWWWWWWWWWWWWWWWWWWWWW     WWWWWWWWWWWWWWWWWWWWWWWWWWWWWW             WWWWWWWWWWWWWWWW
WWWWWWWWWWWWWWWWWWWWWWWWWWWWWWWWWWWWWWWWWWWWWWWWWWWWWWWWWWWWWWWWWWWWWWWWWWWWWWWWWWWWWWWWWWWWWWWWWWWWWWWWWWWWWWWWWWWWWWWW
