111111111111111111111111111111
100000000000000000000000000001
100000000000000000000000000001
100000000000000000000000000001
100000022222000000000000000001
100000000000000000000000000001
120000000000000002200000022001
100000000000000000000000000001
100000000000000000000001111101
100000000000000000000000110001
100000000000000000000000100001
100000000000000000000000100001
111111111111111111111111111111
