wwwwwwwwww
w        w
w        w
w        w
w        w
w    e   w
w  wwww  w
w  w     w
w  w     w
wwwwwwwwww

